! objects.txt
! quests_on
map_
1
1
1
1
1
20
2 9 0 9 3 192 5 1 193 5 1 194 10 1 4342
18 0 0 16 5 195 5 1 196 5 1 197 10 1 198 10 1 199 10 1 4344
17 13 0 4 1 199 1000 1 4345
11 16 0 12 4 200 1 1 201 2 1 202 3 1 204 4 1 4346
0 30 0 9 3 192 4 1 193 5 1 194 10 1 4347
24 31 0 9 3 192 6 1 193 9 1 194 10 1 4348
28 32 0 9 3 192 7 1 193 5 1 194 10 1 4349
15 15 1 14 134 1000 1 2 761 10 100 762 5 25 1 -1 15 15
-1 -1 -1 -1 -1
1 1 0 5 2 180 10 1 181 9 1 4350
0 31 0 5 2 180 10 1 182 10 1 4351
11 2 0 5 2 190 7 1 183 10 1 4352
12 5 0 5 2 189 8 1 184 10 1 4353
18 7 0 5 2 188 4 1 185 10 1 4354
30 1 0 5 2 187 1 1 186 10 1 4355
12 2 1 23 154 1000 0 5 9876 10 95 9875 9 20 9873 15 500 9871 14 550 9870 1 525 1 -1 12 2
-1 -1 -1 -1 -1
19 16 0 5 2 160 10 1 169 10 1 4356
24 9 0 5 2 161 10 1 168 10 1 4357
15 21 0 5 2 162 190 1 167 10 1 4358
8 18 0 5 2 163 10 1 166 10 1 4359
12 20 0 5 2 164 10 1 165 10 1 4360
-2 -2 -2 -2 -2